0   0   0   0   0   0   0   0   0   0   0   0   0   0   0   0   0   0  98  98  98  98
0  21   6  24  20  25   0   0  24  20  25   0  16  16  16  16  16  14  98  77  77  98
0  22  26  23   0  22  26  20  23   0  29  20  16   0  16   0  16  13  98  99  99  98
0   0  21   0   0   0  21   0   0   0  16   0  16  16   0  16  21   7  98  99  99  98
0  20  27  20  25   0   0   0  21   0   0   0  13  16  16  16  22  20  20  28  28   0
0   0  21   0  22  20  20  20  28  25   0   0  16  21  16   0  16  99   0  16  16   0
0   2   5   2   2   2   2   0   0  29  20  25   0  21   0   0  99  99   0   0  33   0
0  24  28  25   0   0   2   2  24  23   0  29  20  28  25   0  13  99  99   0   0   0
0  21   0  21  16  16   4   2  21   0   0  21  14   0  22  25   0  11  99   0  16   0
0  16   0  21  16  16   2   2   2   2   2   5   2  13   0  22  25   0  99  99  99   0
0   0  16  10  15   2   2  15   8  15  15  16   2   2  12   0  21   0   0   0   0   0
0   2   2   2   2   2  15  13  16  16  16  16  15   2   2  11  16  16  16  99  99   0
0   2   2   2  11  16  16  16  10  14  11  16  16  15   2  15  16  16  16  99  16   0
0   0   0   0   0   0   0   0   0   0   0   0   0   0   0   0   0   0   0   0   0   0
