 0   0   0   0   0   0   0   0   0   0   0   0   0   0   0   0   0   0  98  98  98  98
 0  21   0  16  16  16  16  50  50   0   0  50  50   0  16  16  15   0  98  77  77  98
 0  21   0  16   0   0  16   0  50  50  50  20  25   0   0   0  15   0  98  78  78  98
 0  22  20  20  25   0   0   0   0   2   2   2  22  25  13   0  16   0  98  99  99  98
 0  15  16  16  21  15  14  50   2   2   7   2   2  22  25  16  14   0  16  10  10   0
 0  16   2   2   5   2  14   2   2  11  16  16   2   2  21  16  14   0  50   0   0   0
 0  16   2  12  50   2   2   2  16  16  15  16   4   2   5   2  50  50  50  15  15   0
 0   2   2  12  50  16  50   2   2  12  16  16   2   2  50   2   2  50  50   0  16   0
 0  12  12  12  16   0   2   2   2   2  50   2   2  11  21  11   2   2   5   2   2   0
 0   0  50  16  50   0   2  16   0   2   5   2   0  50  21  11  11  11  50   0   0   0
 0   6  16  50   2   2   2  50   0   0  16   0   0  24  23   0   0  50  50   0   8   0
 0  16   0   2   2  14  14  50  50  50  16  16  20  23   0   0  50  50   0   0  50   0
 0  16   0   2  14  16  16   0   0  16  16   0   0  15  50  50  50  15  15  50  16   0
 0   0   0   0   0   0   0   0   0   0   0   0   0   0   0   0   0   0   0   0   0   0
