 0   0   0   0   0   0   0   0   0   0   0   0   0   0   0   0   0   0  98  98  98  98
 0  50  20  26  20   6   0  50  50   0  16  50  50  50  50  50  50  50  98  77  77  98
 0   0   0  50   0   0   0   0  50  16  50   0  16   0  50   0   0  50  98  78  78  98
 0  50   0  50   0  16  50   0  16   0   0   0  16   0  16   0  16  15  98  99  99  98
 0  16   0  16   0   0  50   0  50   0  15  15  50   0  50   0   0   0   0  10  10   0
 0  12   0  16  50  50  15  50  16  16  50  50   0   0  50  50  50  16  50  50  15   0
 0  12   0   0  15   0   0   0   0   0   0  16  50   0  16  50   2   2   2   2   2   0
 0  16   4   0  50  50  50   0   7  50  50  16   2   2   2   5   2  16  13  13  13   0
 0  14   0   0  50   0   0   0   0   0  50  50   2  16   0  50   0   0   0   0  50   0
 0  13   0  50  15  50  50  50  16   0  50   2   2  50   0  50  50  50  50  50  50   0
 0  13   0  16  50   0  11   2   2   2   5   2  50  16   0   0   0   0  50   0   0   0
 0  16   0  16   2   2   2   2  50   0  50   0  50  16  50  50  50   0  15  16   8   0
 0  16  50  50   0   2  16  15  16  15  50  50  50   0   0   0  50  16  50   0  16   0
 0   0   0   0   0   0   0   0   0   0   0   0   0   0   0   0   0   0   0   0   0   0
